NO ./resources/wall1.xpm
SO ./resources/wall2.xpm
WE ./resources/wall3.xpm
EA ./resources/wall4.xpm


C 225, 0   ,    0     
F 220,100,0

1111111111111111
1000000100000001
1000X00100000001
1100110000111011
1000000100000001
10000001000N0001
1111111111111111