



SO      ./resources/wall2.xpm
C 171,154,137
WE ./resources/wall3.xpm

F 139,99,58
EA ./resources/wall4.xpm

NO ./resources/wall1.xpm

1111111111111111111
1001001001001001001
1001001001001001001
100100101001001001
1001001000001001001
100000000S000000001
1000011111111000001
1111000000000001111
1000000101010000001
1111111111111111111